111111111111111
1001000c10011E1
10011100c100101
1100P00110c0001
111111111111111