111111111111111
1101000C10011E1
10011100C100101
1100000110CP001
111111111111111