111111111111111
110000VC10011E1
10000000C000001
1C00000110CPV01
1C0000000000001
1C00V00000C0001
111111111111111
char **map;

map = malloc(sizeof(char *) * count_line + 1);



while(gnl(fd, map[i++]));



map[]
\0;
